<!DOCTYPE html>
<html lang="en">
<head>
    <meta charset="UTF-8">
    <meta name="viewport" content="width=device-width, initial-scale=1.0">
    <title>Document</title>
</head>
<body>
    <h1>HTML TAGLARI</h1>
    <p>!–…–= Yorum tanımlar
!DOCTYPE= Belge türünü belirler<br>
a =Bir köprüyü tanımlar<br>
abbr= Bir kısaltma veya bir kısaltma tanımlar<br>
acronym= Bir kısaltma tanımlar (HTML5’te abbr kullanılır)<br>
address= Bir belgenin yazarı / sahibinin iletişim bilgilerini tanımlar<br>
applet= Gömülü bir uygulamasını tanımlar.(HTML5’te Embed veya object kullanılır)<br>
area= Bir görüntü haritası içinde bir alanı tanımlar<br>
article= Bir makale tanımlar<br>
aside= Sayfa içeriğini kenara tanımlar<br>
audio= Ses içeriğini tanımlar<br>
b= Kalın metin tanımlar<br>
base= Bir belgedeki tüm göreli URL’ler için taban URL / hedef belirler<br>
basefont= Bir belgedeki tüm metin için bir varsayılan renk, boyut ve yazı belirtir (HTML5 desteklenmez. Bunun yerine CSS kullanın)<br>
bdi= Bunun dışındaki diğer metinden farklı bir yöne biçimlendirilmiş olabilir metnin bir kısmını izole eder<br>
bdo= Geçerli metin yönünü geçersiz kılar<br>
big= Büyük metin tanımlar (HTML5 desteklenmiyor. CSS yerine kullanın)<br>
blockquot= Başka bir kaynaktan alıntı bölüm tanımlar<br>
body= Belgenin cesedini tanımlar<br>
br= Tek bir satır sonu tanımlar<br>
button= Tıklanabilir bir düğme tanımlar<br>
canvas= Scripting aracılığıyla anında, grafik çizmek için kullanılır (genellikle JavaScript)<br>
caption= Bir tablo başlığını tanımlar<br>
center= Merkezli metni tanımlar (HTML5 desteklenmiyor. CSS yerine kullanın)<br>
cite= Bir eserin başlığını tanımlar<br>
code= Bilgisayar kodunun bir parçasını tanımlar<br>
col= Bir COLGROUP elemanı içinde her sütun için sütun özelliklerini belirtir<br>
colgroup= Biçimlendirmek için bir tablo, bir veya daha fazla sütun grubu belirtir<br>
datalist= Giriş kontrolleri için önceden tanımlanmış seçenekler listesini belirtir
dd= Bir açıklama listesindeki bir terimin açıklaması / değerini tanımlar<br>
del= Bir belgeden silindi metni tanımlar<br>
details= Kullanıcı görüntülemek veya gizlemek ek ayrıntılar tanımlar<br>
dfn= Bir terimin tanımlanması örneğini temsil<br>
dialog= Bir iletişim kutusu veya pencere tanımlar<br>
dir= Bir dizin listesini tanımlar(HTML5 desteklenmiyor.ul kullanın)<br>
div= Bir belgedeki bölüm tanımlar<br>
dl= Bir açıklama listesi tanımlar<br>
dt= Bir açıklama listesinde bir terim / isim tanımlar<br>
em= Vurguladı metni tanımlar<br>
embed= Harici (HTML olmayan) uygulama için bir kabı tanımlar<br>
fieldse= Gruplar bir form elemanları ile ilgili<br>
figcaption= Bir rakam öğesi için bir başlık tanımlar<br>
figure= Kendi kendine yeten içeriği belirtir<br>
font= Metin için yazı tipi, renk ve boyutunu tanımlar<br>
footer= Bir belgenin veya bölümün altbilgi tanımlar<br>
form= Kullanıcı girişi için bir HTML formu tanımlar<br>
frame= Kullanıcı girişi için bir HTML formu tanımlar…<br>
frameset= Kare seti tanımlar<br>
h1= to<br>
h6= HTML başlıkları tanımlarhead&gt; Belge ile ilgili bilgiler tanımlar<br>
header= Bir belgenin veya bölümün bir başlık tanımlar<br>
hr= Içerik tematik değişiklik tanımlar<br>
html= Defines the root of an HTML document<br>
i= Bir HTML belgesinin kök tanımlar<br>
iframe= Bir satır içi çerçeve tanımlar<br>
img= Bir görüntü tanımlarinput&gt; Bir giriş kontrolü tanımlar<br>
ins= Bir belgeye yerleştirilmiş olan bir metin tanımlar<br>
kbd= Klavye girişi tanımlar<br>
keygen= (Formlar için) bir anahtar çifti jeneratör alanını tanımlar<br>
label= Bir input öğesi için bir etiket tanımlar<br>
legend= Bir fieldset öğesi için bir başlık tanımlar<br>
li= Bir liste öğesini tanımlar<br>
link= Bir belge ve harici kaynak arasındaki ilişki (en stil sayfalarını bağlamak için kullanılır) tanımlar<br>
main= Bir belgenin ana içeriğini belirler<br>
map= Bir istemci tarafı görüntü haritası tanımlar<br>
mark= İşaretli / vurgulanan metni tanımlar<br>
menu= Komutların bir listesini / menü tanımlar<br>
menuitem= Kullanıcı açılır menüden çağırabilirsiniz bir komut / menü öğesi tanımlar<br>
meta= Bir HTML belgesi hakkında meta tanımlar<br>
meter= Bilinen bir aralık içinde bir sayıl ölçümünü tanımlar (bir ölçü)<br>
nav= Navigasyon bağlantıları tanımlar<br>
noframes= Çerçeveleri desteklemeyen kullanıcılar için alternatif bir içerik tanımlar<br>
noscript= Istemci tarafı komut desteği olmayan kullanıcılar için alternatif bir içerik tanımlar<br>
object= Katıştırılmış nesne tanımlar<br>
ol= Sıralı liste tanımlar<br>
optgroup= Bir açılan listesinde ilgili seçeneklerin bir grup tanımlar<br>
option= Bir açılır listeden bir seçenek tanımlar<br>
output= Bir hesaplamanın sonucunu tanımlar<br>
p= Bir paragraf tanımla<br>r
param= Bir nesne için bir parametre tanımlar<br>
pre= Önceden biçimlendirilmiş metni tanımlar<br>
progress= Bir görevin ilerlemesini temsil<br>
q= Kısa bir alıntı tanımlar<br>
rp= Yakut açıklamaları desteklemeyen tarayıcılarda göstermek ne tanımlar<br>
rt= (Doğu Asya tipografi için) karakter bir açıklama / telaffuz tanımlar<br>
ruby= (Doğu Asya tipografi için) bir yakut ek açıklama tanımlar<br>
s= Artık doğru metin tanımlar<br>
samp= Bir bilgisayar programı örnek çıktı tanımlar<br>
script= Bir istemci tarafı komut dosyası tanımlar<br>
section= Bir belgedeki bölüm tanımlar<br>
select= Bir açılır listeyi tanımlar<br>
small= Daha küçük metin tanımlar<br>
source= (Video ve audio) medya unsurları için birden fazla medya kaynakları tanımlar<br>
span= Bir belgedeki bölüm tanımlar<br>
strike= Çizili metni tanımlar(HTML5 desteklenmiyor. del veya s kullan)<br>
strong= Önemli metni tanımlar<br>
style= Bir belge için stil bilgilerini tanımlar<br>
sub= Indisli metni tanımlar<br>
summary= Bir detay elemanı için görünür bir başlık tanımlar<br>
sup= Üstsimge metni tanımlar<br>
table= Tablo tanımlartbody&gt; Gruplar bir tablo vücut içeriği<br>
td= Bir tablodaki bir hücreyi tanımlar<br>
textarea= Çok satırlı giriş kontrolünü tanımlar (metin alanı)<br>
tfoot= Gruplar bir tablo altbilgi içeriği<br>
th= Bir tablodaki bir başlık hücreyi tanımlar<br>
thead= Bir tablodaki bir başlık hücreyi tanımlar<br>
time= Bir tarih / saat tanımlar<br>
title= Belge için bir başlık tanımlar<br>
tr= Bir tablodaki bir satır tanımlar<br>
track= (Video ve audio) medya unsurları için metin parçalarını tanımlartt&gt; Teletype metni tanımlar<br>
u= Normal metinden üslup farklı olmalıdır metni tanımlar<br>
ul= Sırasız liste tanımlar<br>
var= Bir değişken tanımlar<br>
video= Bir video veya film tanımlar<br>
wbr= Olası bir çizgi-break tanımlar </p><br>
</body>
</html>